IIIRRWWWWRRRIIIRRRRRRRRRRR
IWWWRWWWWRWWWWWRWWWWWWWWWR
IWWWRWWWWRWWWWWRWRRRRRRRRR
IWWWRRRRRRRRRRRRWRWWWWWWWR
IRRRRRWWWWRWWWWWWRWWWWWWWR
IWWWWWWWWWRWWWWWWRRRRRRRRR
IWWWWWWWWWRWWWWWWRWWWWWWWR
IWWWWWWWWWRWWWWWWRWWWWWWWR
RWRRRRRIWWRRRRRRRRWWWWWRRR
RWRWWWWIWWRHHHWWWWWWIIIRWW
RWRWWWWIWWRHHHWWWWWIIWWWWW
RWRWWWWIRRRRRWWWWWWRWWRRRR
RWRWWWWRWWWWRWWWWWWRWWRWWR
RWRWWWWRWWWWRWWWWWWRWWRWWR
RRRRRRRRWWWWRRRRRRRRRRRWWR
IWWWWWWWWWWWWRWWWWWWWWRWWR
IWWWWWWWWWWWWRWWWWWWWWRWWR
IWWWWWWWWWWWWRRRRRRRRRRWWR
IRRRRRRRWWWWWRRWWWWWWWRRRR
IRRRRRRRWWWWWWRWWWWWWWWWWR
IWWWWWWWWWWWWWRWWWWWWWWWWR
IWWWWWWWWWWWWWRWWWWWWWWWWR
IRRRRRRRRRRRRRRWWWWWWWWWRR
WWWWWWWWWWWWWWRWWWWWWWWWRW
WWWWWWWWWWWWWWRRRIIIIIIRRW
&&&
20 0
5 3
17 5
0 14
20 14
13 17
25 18
7 22
***
