IRRRRRRRRIIIIIIIIIRR
IWWWWWRRRRWRWRWWWWWR
IWWWWWRWWRWRWRWWWWWR
IWWWWWRWWRWRWRWWWWWR
RRRWWWRWWRWRWRWWWWWR
RWRWWWRWWRRRWRRRWWWR
RWRWWWRWWRRRWWWRWWWR
RWRWWWRRWHHHWWWRWRRR
RWRWWWWRWHHHWIIIIRWR
RWRRRRRRRRRRWRWWWRWR
RWRWWWWWWWWRWRWWWRWR
RWIWWWWWWWWRWRWWWRWR
RWIWWWWWWWWRWRWWWRWR
RWIWWWWWWWWRWRWWWRWR
RWIRRRRRRRRRRRWIRRWR
RWIWWWWWWRWWWRWIWRRR
RWIWWWWWWRWWWRWIWWWW
RWIWWWWWWRWWWRWIWWWW
RWIWWWWWWRWWWRWIWWWW
RRRRRRRRRRRRRRIIWWWW
&&&
5 0
19 4
2 9
11 11
0 17
12 19
***