RRRRRRRRRWWWWWRRRRRRRRRRRRR
RWWWRWWWRWRRRWRRWWWRWRRRRRW
RWRWRWRRRWRWRWRRWRRRWWRRRWW
RWRRRWWWRWRRRWWRWWWRWWWRWWW
RWRRRWRRRWRRRRWRWRRRWRWWWRW
RWWWRWWWRWRWWRWRWWWRWRRRRRW
RRRRRRRRRRIIIIRRRRRRRRRRRRR
WWWWRWRRWHHHHWRRRWWRRWRWWWR
WIIIRWRRWHHHHWWRWWWRRWRWRRR
WIWIRWWRWRRRRRWWWRWWRWRWWWR
WIIIRWWWWRRRRRRWRRWWWWRWRRR
WWWWRWRWWRRRRRRWRRWRWWRWWWR
RRRRRRRRRRRRRRRRRRRRRRRRRRR
RWRRRWRIIIRWWWIWWWWWWWRWWWW
RWRWRWRIWIRWRRRWWRRRRWRWRRR
RWWWWWRIIIRWRWRWWRWWRWRWWWR
RWWRWWRRRRRWRRRRWRWWRWRWRRR
RWRRRWRRRRRWRWWRWRRRRWRWRRR
RRRRRRRRRRRRIIIIIRRRWWRWWWR
RWRRRRRRRRRRRRRRWWWWWRRRRRR
RWRRRRRWWWRRRRRRRRRRRRWWWWW
RWWWRRWWWWRWRRRWWRWRRRWRRRW
RWWWWWWWWWWWRRRWWWWRRRWRWRW
RWWWWWRWWWWWWWWWRRWWRRWRRRR
RRRRRRRRRRRRRRRRRRRRRRIRWWR
&&&
14 0
2 2
23 10
6 12
18 14
8 17
0 21
25 21
17 23
***
