RRRRRRRRWWWWWWWRRRRI
RWWWWWWRWWWWWWWRWWWI
RWWWWWWRRRRRWWWRWWWI
RRRRRRRRHHHRWWWRWWWR
RWWWWWWRHHHRWWWRRRRR
IWWWWWWRRRRRRRRRWWWR
IWWWWWWWWRWWRWWWWWWR
RWWWWWWWWRWWRWWWWWWR
RWWWWWWWWRWWRWWWWWWR
RRIIIIIIRRRRRRRIIIIR
&&&
3 0
17 0
19 5
0 8
13 9
***