RRRRRRIIIWWWWWWWRIIIIIIIR
RWWWWWRRRWWWRRRWRWWWWWWWR
RWWWWWRRRWWWRWWWRRRRRWRRR
RWRRRRRRRWWWRWWWRWWWRWRWW
RWRWWWWWRWWWRRRRRRRRRWRWW
RWRWWWWWRWWWRWWWWIWWRRRWW
IWRWWRRRRRWWRWWWWIWWRWRWW
IWRWWRRRRRRRRRRRRIWWRWRWW
IWRWWRRRRRHHHHWWWIWWRWRRR
IRRWWWWWRRHHHHWRRRRRRWWWR
IWRWWWWWRRRRRRWRWRWWRWWWR
IWRRRRRRRWWWWRWRWRWWRWWWR
IWWWWWWWIWRRWRWRWRWWRRRRR
IWWWWWWWIWRRWRRRWRWWWIWWR
IWRRRRRRRWWRWRWRWRWWWIWWI
IWRWWWWWRRRRRRWRRRRWWIRWI
IWRWWWWWRWWWRWWWWWRWWWRWI
IWRWWRRRRRRRRWWWWWRWWWRWI
IWRWWRWWWWWWRWWWWWRIIRRWI
IWRWWRWRRRRRRRRRRRRWWRWWI
IWRWWRWRWWWWWWWWWWRWWRWRR
RWRWWRWRRWRRRRRRRRRWWRWRW
RWRWWRWRRWRWWWWWWWRRRRWRW
RWRWWRWRRWRRRWWWWWRWWWWRW
RRRRRRRRRRRRRIIIIIRRRRRRW
&&&
24 0
7 2
12 3
5 7
0 9
20 9
13 12
14 19
6 24
***