WWWWWWWWWWWRRRRRRWWW
RRRWRRRRRRWRWWWWRRRW
RRRIIIWWWRWRWWRRRWRW
WWWIIIWWWRWRWWRWWWRW
WRWWWRWRRRWRRRRRRRRW
WRRRRRWRRRRRRWWWWRWW
WRWWWRWRRHHHRWIIWRWW
WRWRWRRRRHHHRWWIWRWW
WRWRWRRRRRRRRRRRRRRI
IIIIRRWRWWWWRWWWWRRI
IIIIWWWRWRRRRRRRWWWI
WWRWWWRRWWWWWRRRRRRI
WRRWRRRRRRRRWWWRRWWI
WRWWRRWWWWWRWWRRRWWI
WRWRRRRRRWWRRRRRRWRI
WRWRWRRRIIWWRRWRRWRW
WRRRWRRWIIWWRRWRRRRW
WRRRWRRWIIRWWWWWWRWW
WWWRWRWWWRRWWWWWRRWW
RRRRWRRWRRRRRRRRRRRR
RIIRWRRWWRWWWRWWRWWR
RIIRRRRRRRRRWRWWRWRR
RIIWWWWWWWWWWRWWRRRR
RRRRRIIIIWWWWRWWWWWR
RRRRRIIIIRRRRRRRRRRR
&&&
0 1
16 2
1 12
15 14
8 19 
23 21
***