RRRRRRRRRRWRRRRRRRRWRRRRR
RRRWRRRRRWRWRRRRWRWRRRWRR
RWRWRWRRRRRRRRRWRRRWRRRWR
RWWWWWRRRRWRRRWRRRRRWRWRR
RRRRRRRRRWRWRRRRRRRWRRRRR
RWWWWWRRWIIIWRRRRWRRWRRWR
RRRWRRRRRIWIRRWRRWRWRRWRR
RRWIIIRRRIIIRWRRRRWRRRRWR
RWRIWIRWRHHHHRWRRWRRWRRRR
RRRIIIRWRHHHHRRRWRRWWWRRR
RWRRRRRWRRRRRRRRRRWRRWRWR
RWRRWRRRRRWWRRRRRRRRWRRWR
RRRWRRRRWRRRRWWRRRRWRRRRR
RRWRRRWWWWWRRWRRRRWRRRRRR
RWRRWRRWRRRRWWWWWRRRWWWWR
WRRWRRWWWWWRRRRWRRRRRRRWR
RRWRRRRRRRWWRRRWRRWRWRWRR
RWRRRRWWWWRRWRWWRRWRRWRRR
WRWRRRWRRWRRRWWRRRWRRRWRR
RRWRRRWIIWRRWWRWRRWRRRRRR
RRWRRRWRRWRWWRRWWRRRRRRRR
RRWRRRWIIWRWRRRRWRRRWRRRW
RRWRRRWRRWRRRRRRRRRRRWRWR
RRRRRRRRRRRRRRRRRRRRRRWRR
WWWRRWWWRWWRWWWRWWRRRWRRR
RRRRRRRRRRRRRRRRRRRRRRRRR
&&&
10 1
20 1
2 2
23 6
20 10
0 14
13 15
10 17
19 22
***
